적 캐릭터수 : 9
적 캐릭터가 출현할 위치 개수 : 9
3 1
9 1
21 1
7 5
16 6
7 9
1 11
21 12
1 16
보스 초기 위치 : 12 16
플레이어 초기 위치 : 11 14
적 캐릭터 종류 개수 : 2
생명력: 2 이동시간 간격: 800 미사일: 2000
생명력: 3 이동시간 간격: 700 미사일: 2500
타입인덱스: 0 적캐릭터 생성 인덱스: 2 출현 시간: 1000
타입인덱스: 1 적캐릭터 생성 인덱스: 0 출현 시간: 2000
타입인덱스: 0 적캐릭터 생성 인덱스: 1 출현 시간: 3000
타입인덱스: 0 적캐릭터 생성 인덱스: 3 출현 시간: 3000
타입인덱스: 1 적캐릭터 생성 인덱스: 4 출현 시간: 3000
타입인덱스: 0 적캐릭터 생성 인덱스: 5 출현 시간: 3500
타입인덱스: 1 적캐릭터 생성 인덱스: 6 출현 시간: 3600
타입인덱스: 1 적캐릭터 생성 인덱스: 7 출현 시간: 5000
타입인덱스: 0 적캐릭터 생성 인덱스: 8 출현 시간: 5500
2 2 2 2 2 2 2 2 2 2 2 2 2 2 2 2 2 2 2 2 2 2 2 
2 0 0 3 0 0 1 0 0 3 0 0 2 0 0 0 0 0 0 0 0 3 2 
2 0 0 0 0 0 1 0 0 0 0 0 2 0 0 0 0 0 0 0 0 0 2 
2 2 2 0 0 0 0 0 0 0 0 0 2 0 0 0 1 1 1 0 0 0 2 
2 0 0 0 0 0 0 0 0 0 0 0 2 0 0 0 1 1 1 0 0 0 2 
2 0 0 0 0 0 0 3 0 0 0 2 2 2 0 0 0 0 0 0 0 0 2 
2 1 1 0 0 0 2 0 0 0 0 0 0 0 0 0 3 0 0 0 0 0 2 
2 0 0 0 0 0 0 1 1 0 0 0 0 0 0 0 0 0 0 0 0 0 2 
2 0 0 0 0 0 0 0 0 0 0 0 0 2 2 0 0 0 0 0 0 0 2 
2 0 0 0 0 0 2 3 0 0 0 0 0 2 2 0 0 0 0 2 2 2 2 
2 2 2 0 0 2 2 0 0 0 0 0 0 0 0 0 0 0 0 0 0 0 2 
2 3 0 0 0 0 0 0 0 0 0 0 0 0 0 0 0 0 0 0 0 0 2 
2 0 0 0 0 0 0 0 1 1 0 0 2 0 0 0 0 0 0 0 0 3 2 
2 0 0 0 1 1 0 0 0 0 0 0 0 0 0 0 1 1 0 0 0 0 2 
2 0 0 0 1 1 0 0 0 0 0 5 0 0 0 0 1 1 0 0 0 0 2 
2 0 0 0 0 0 0 0 0 0 0 1 1 1 0 0 0 0 0 0 0 0 2 
2 3 0 0 0 0 0 0 0 0 0 1 4 1 0 0 0 0 0 0 0 0 2 
2 2 2 2 2 2 2 2 2 2 2 2 2 2 2 2 2 2 2 2 2 2 2 
